boss1
15 10
###############
#             #
#   ** **     #
#   ** **     #
#    ***      #
#             #
###         ###
#             #
#             #
#######aa######