village1
15 10
#######cc######
#     #  #    #
#     #  #    #
#######  ######
#             e
#        ###  #
#######    #  #
#     #    #  #
#  #       #  #
############bb#