village2
15 10
############aa#
#             #
#  #          #
#             #
#       #     #
#             #
#           # #
#             #
#  #       #  #
############dd#