village3
25 15
############bb###########
#                       #
#  #                    #
#                       #
#       #               #
#                       #
#           #           #
#                       #
#  #       #            #
##################      #
#                       #
#                       #  
#      ############     #
#      #          #######
######## 