village4
15 10
###############
#     #  #    #
#        #    #
#    #        #
a #           #
#   #    ##   #
# #   #    #  #
#  #   #    # #
#          #  #
###############